11111111111111111
1CCCCCCEC0C000011
1CPCC00C1C1C1C111
11111111111111111
