11111111111111111
10E00000000111111
1CP0C111001010111
11111111111111111
