1111111
1000001
1P111C1
10E0001
1111111