111111111111111  
1P00000000000E1  
101111111111101  
1C0000000000001  
111011111101111  
1C00000000000C1  
101111111111101  
1C0000000000001  
111011111101111  
1C00000000000C1  
101111111111101  
1C0000000000001  
111111111111111  
