111111111111111111111111111
1P0000100000000001000000C01
101110101111111101011111101
101010100000000000010000101
101010111111111111010110101
10101000000C00000001010E101
101011111111111110010111101
101000000000000010010000001
10111111111111101001111C101
100000000000000100000000101
111111111111111111111111111