111111111111111111111111
1P000000C00000000000C001
100111111111000111110001
100100000001000100010001
100100111001000100010001
10010010C001000100C10001
100100100001000100010001
100111111111000111110001
1000000000000000000E0001
111111111111111111111111