1111111111111111111111111
1P00000000000000000000001
1011111111111111111111101
1010000000000000000000101
1010111111111111111110101
101010000000000000001C101
1010101111111111111010101
1010100000000000000010101
1010111111111111111010101
101000000000000C000010101
1011111111111111111110101
10000000000000000000000E1
1111111111111111111111111